width=10
height=10
money=500
name=Забытый Храм
tiles=
0 0 0 0 0 0 0 0 0 0
0 1 2 4 0 0 4 2 3 0
0 0 2 0 0 0 0 2 0 0
0 4 2 4 0 0 4 2 4 0
0 0 2 0 0 0 0 2 0 0
0 0 2 2 2 2 2 2 0 0
0 4 4 4 2 4 4 4 4 0
0 0 0 0 2 0 0 0 0 0
0 0 0 4 2 4 0 0 0 0
0 0 0 0 0 0 0 0 0 0
waves=
basic:20
fast:20
strong:15
basic:50
fast:40
strong:30