width=12
height=7
money=400
name=Снайперская миля
tiles=
0 0 0 0 0 0 0 0 0 0 0 0
0 1 2 2 2 2 2 2 2 2 4 0
0 4 4 4 4 4 4 4 4 2 0 0
0 0 0 0 0 0 0 0 0 2 4 0
0 4 2 2 2 2 2 2 2 2 0 0
0 0 2 4 4 4 4 4 4 4 0 0
0 0 3 0 0 0 0 0 0 0 0 0
waves=
strong:3
basic:10
strong:6
fast:20
strong:10
basic:40