width=12
height=9
money=320
name=Последний рубеж
tiles=
0 0 0 0 0 0 0 0 0 0 0 0
0 1 2 2 2 0 0 0 0 0 0 0
0 4 2 4 4 4 0 0 0 0 3 0
0 4 2 4 0 2 2 2 2 2 2 0
0 4 2 4 0 2 4 4 0 4 2 0
0 4 2 2 2 2 0 4 0 4 2 0
0 4 4 4 4 4 0 4 4 4 2 0
0 0 0 0 0 0 0 0 0 0 2 0
0 0 0 0 0 0 0 0 0 0 0 0
waves=
basic:10
fast:10
strong:8
fast:12
strong:10
basic:15
fast:10
strong:8
fast:12
strong:10