width=12
height=8
money=300
name=Змейка
tiles=
0 0 0 0 0 0 0 0 0 0 0 0
0 1 2 2 4 0 0 0 0 0 0 0
0 0 4 2 0 4 2 2 2 4 0 0
0 0 0 2 2 2 2 4 2 0 0 0
0 4 0 4 4 4 0 0 2 4 4 0
0 2 2 2 2 2 2 2 2 2 4 0
0 2 4 4 4 4 4 4 4 2 2 3
0 0 0 0 0 0 0 0 0 0 0 0
waves=
basic:10
fast:8
basic:15
fast:12
strong:2