name=Дикое Поле
stars=15 35 75
coins=500
width=15
height=8
tiles=
0 0 0 0 0 0 0 0 0 0 0 0 0 0 0
1 2 2 2 2 2 2 2 2 2 2 2 2 2 3
0 4 0 4 0 4 0 4 0 4 0 4 0 4 0
0 0 0 0 0 0 0 0 0 0 0 0 0 0 0
0 0 4 2 2 2 2 2 2 2 2 2 4 0 0
0 0 0 2 0 0 0 0 0 0 0 2 0 0 0
0 4 2 2 2 2 2 2 2 2 2 2 2 4 0
0 0 0 0 0 0 0 0 0 0 0 0 0 0 0
enemies=basic fast strong
