name=Шепоты Глубин
stars=30 60 120
coins=550
width=15
height=7
tiles=
1 2 2 2 2 2 2 2 2 2 2 2 2 2 4
0 0 0 0 0 0 0 0 0 0 0 0 0 2 0
4 2 2 2 2 2 2 2 2 2 2 2 0 2 0
0 2 0 0 0 0 0 0 0 0 0 2 0 2 0
0 2 0 2 2 2 2 2 2 2 2 2 2 2 0
0 2 0 2 4 0 0 0 4 0 0 0 0 0 0
0 2 2 2 0 0 0 0 0 0 0 4 2 2 3
enemies=basic fast strong
