width=13
height=11
money=250
name= Жестяная коробка
tiles=
0 0 0 0 0 0 0 0 0 0 0 0 0
0 0 0 4 0 0 0 0 0 0 0 0 3
0 0 2 2 2 2 2 2 0 0 0 4 2
0 0 2 0 0 0 0 2 0 0 0 0 2
0 0 2 0 4 0 0 2 0 0 4 0 2
0 0 2 0 0 0 0 2 2 2 2 2 2
0 4 2 0 0 0 0 0 0 0 0 0 4
0 0 2 2 2 2 0 0 0 0 0 0 0
0 0 0 0 0 2 0 0 4 0 0 0 0
0 0 0 4 0 2 0 0 0 0 0 0 0
1 2 2 2 2 2 0 0 0 0 0 0 0
waves=
basic:60
fast:70
strong:80
basic:80
fast:80
strong:100
basic:120
fast:130
