name=Огненный Разлом
stars=20 40 80
coins=400
width=12
height=12
tiles=
1 2 2 2 2 2 2 0 0 0 0 0
0 0 0 0 0 0 2 4 0 0 0 0
0 0 4 0 0 0 2 0 0 0 0 0
0 0 2 2 2 2 2 0 4 0 0 0
0 0 2 0 0 0 0 0 2 0 0 0
0 0 2 0 4 0 0 0 2 0 0 0
0 0 2 2 2 2 2 2 2 0 0 0
0 0 0 0 0 4 0 0 2 0 0 0
0 0 0 4 2 2 2 2 2 2 4 0
0 0 0 0 2 0 0 0 0 2 0 0
0 0 0 0 2 2 2 2 2 2 2 3
0 0 0 0 4 0 0 0 4 0 0 0
enemies=basic fast strong
