width=20
height=10
money=300
name=Крепость
tiles=
0 0 0 0 0 0 0 0 0 0 0 0 4 0 0 0 0 0 0 0
0 1 2 2 2 2 0 2 2 2 2 2 2 0 0 0 0 0 0 0
0 0 0 0 4 2 0 2 4 0 0 0 2 0 4 0 0 0 0 0
0 0 0 0 0 2 2 2 0 0 0 4 2 2 2 2 0 0 0 0
0 0 0 0 0 0 0 0 0 0 0 0 0 0 0 2 4 0 0 0
0 0 0 0 4 0 0 0 0 0 0 0 0 0 0 2 0 0 0 0
0 0 0 0 0 0 0 0 0 0 0 4 0 0 4 2 0 0 0 0
0 0 0 0 0 0 0 0 0 0 0 0 0 0 0 2 0 0 0 0
0 0 0 0 0 0 0 0 0 0 0 0 0 2 2 2 2 2 3 0
0 0 0 0 0 0 0 0 0 0 0 0 0 0 0 0 0 0 0 0
waves=
basic:50
basic:40
fast:60
strong:30
basic:40
basic:45
strong:50
