width=14
height=9
money=350
name=Осада
tiles=
0 0 0 0 0 0 0 0 0 0 0 0 0 0
0 1 2 2 2 2 2 2 2 2 2 4 0 0
0 4 4 4 4 4 4 4 4 4 2 0 0 0
0 0 2 2 2 2 2 2 4 0 2 4 0 0
0 0 2 4 4 3 4 2 0 0 2 0 0 0
0 0 2 0 0 2 4 2 0 0 2 0 0 0
0 0 2 2 2 2 0 2 2 2 2 4 0 0
0 4 4 4 4 4 4 4 4 4 4 0 0 0
0 0 0 0 0 0 0 0 0 0 0 0 0 0
waves=
basic:15
basic:20
strong:5
fast:15
strong:8
basic:30