name=Забытый Пост
stars=10 25 50
coins=280
width=10
height=8
tiles=
0 0 0 0 0 0 0 4 0 0
1 2 2 2 2 2 2 2 4 0
0 0 4 0 0 0 0 2 0 0
0 4 2 2 2 2 4 2 0 0
0 0 2 4 0 2 2 2 0 0
0 4 2 0 0 4 0 0 0 0
0 0 2 2 2 2 2 2 2 3
0 0 0 4 0 0 0 4 0 0
enemies=basic fast
