name=Кровавый Берег
stars=15 30 60
coins=420
width=14
height=6
tiles=
1 2 2 4 0 0 4 2 2 2 2 2 2 3
0 0 2 0 0 0 0 2 0 0 0 0 0 0
0 4 2 2 2 2 2 2 4 0 0 4 0 0
0 0 0 0 0 0 0 0 0 0 0 2 2 0
0 4 2 2 2 2 2 2 2 2 2 2 4 0
0 0 0 0 4 0 0 0 4 0 0 0 0 0
enemies=basic fast strong
