name=Мертвая Петля
stars=12 30 60
coins=300
width=12
height=7
tiles=
0 0 0 4 0 0 0 4 0 0 0 0
1 2 2 2 2 2 2 2 2 2 2 3
0 2 4 0 0 4 0 0 0 4 2 0
0 2 2 2 2 2 2 2 2 2 2 0
0 4 0 0 0 4 0 0 0 4 0 0
0 2 2 2 2 2 2 2 2 2 2 0
0 0 0 4 0 0 0 4 0 0 0 0
enemies=basic fast
