width=13
height=11
money=250
name=Сердечко
tiles=
0 0 0 0 0 0 0 0 0 0 0 0 0
0 2 2 2 2 0 0 0 2 2 2 2 0
0 2 4 4 2 0 0 0 2 4 4 2 0
0 2 4 4 2 1 0 3 2 4 4 2 0
0 2 4 0 4 4 2 4 4 0 4 2 0
0 2 4 0 0 4 4 4 0 0 4 2 0
0 2 2 4 0 0 4 0 0 4 2 2 0
0 0 2 2 4 0 0 0 4 2 2 0 0
0 0 0 2 2 4 4 4 2 2 0 0 0
0 0 0 0 2 2 2 2 2 0 0 0 0
0 0 0 0 0 0 0 0 0 0 0 0 0
waves=
basic:15
fast:20
strong:30
basic:20
fast:20
strong:40
basic:33
fast:12
