width=10
height=7
money=220
name=Перекрёсток
tiles=
0 0 0 0 0 0 0 0 0 0
0 1 2 2 2 0 0 0 0 0
0 4 2 4 4 4 0 0 3 0
0 4 2 4 0 2 2 2 2 0
0 4 2 4 0 2 4 4 2 0
0 0 2 2 2 2 0 0 2 0
0 0 0 0 0 0 0 0 0 0
waves=
basic:6
fast:4
basic:12
fast:4
basic:12
fast:8