name=Старая Шахта
stars=10 20 40
coins=350
width=15
height=5
tiles=
1 2 2 2 4 2 2 2 4 2 2 2 4 2 3
0 0 0 2 0 2 0 2 0 2 0 2 0 2 0
4 4 4 2 4 2 4 2 4 2 4 2 4 2 4
0 0 0 2 2 2 2 2 2 2 2 2 2 2 0
0 0 0 0 0 0 0 0 0 0 0 0 0 0 0
enemies=basic fast strong
