name=Темная Темница
stars=20 40 80
coins=300
width=8
height=12
tiles=
1 2 4 0 0 0 0 0
0 2 0 0 0 0 0 0
4 2 2 2 4 0 0 0
0 0 0 2 0 0 0 0
0 4 0 2 2 2 4 0
0 0 0 0 0 2 0 0
0 0 4 2 2 2 0 0
0 0 0 2 0 0 0 0
0 4 2 2 4 0 0 0
0 0 2 0 0 0 0 0
4 2 2 2 2 2 2 3
0 0 0 0 4 0 0 0
enemies=basic fast strong
