name=Вечный Город
stars=25 50 100
coins=600
width=13
height=13
tiles=
0 0 0 0 0 0 4 0 0 0 0 0 0
0 1 2 2 2 2 2 2 2 2 2 3 0
0 2 0 0 0 0 2 0 0 0 0 2 0
0 2 0 4 0 0 2 0 0 4 0 2 0
0 2 2 2 2 2 2 2 2 2 2 2 0
0 0 0 0 0 0 2 0 0 0 0 0 0
0 4 2 2 2 2 2 2 2 2 2 4 0
0 0 0 0 0 0 2 0 0 0 0 0 0
0 2 2 2 2 2 2 2 2 2 2 2 0
0 2 0 4 0 0 2 0 0 4 0 2 0
0 2 0 0 0 0 2 0 0 0 0 2 0
0 2 2 2 2 2 2 2 2 2 2 2 0
0 0 0 0 0 0 4 0 0 0 0 0 0
enemies=basic fast strong
