name=Горный Хребет
stars=15 30 60
coins=400
width=11
height=8
tiles=
0 0 0 0 0 0 0 4 0 0 0
1 2 2 4 0 4 2 2 2 2 3
0 0 2 0 0 0 2 0 0 0 0
0 4 2 2 2 2 2 4 0 0 0
0 0 0 0 0 0 2 0 0 0 0
0 4 2 2 2 2 2 2 2 4 0
0 0 2 0 0 0 0 0 2 0 0
0 0 2 2 2 2 2 2 2 0 0
enemies=basic fast strong
