name=Змеиный Спуск
stars=15 35 70
coins=240
width=9
height=9
tiles=
1 2 2 2 4 0 0 0 0
0 0 0 2 4 0 0 0 0
4 2 2 2 0 0 4 0 0
0 2 4 0 0 2 2 2 4
0 2 2 2 2 2 4 2 0
4 0 0 4 0 0 0 2 0
0 0 0 2 2 2 2 2 0
0 4 0 2 4 0 0 0 0
0 0 0 2 2 2 2 2 3
enemies=basic fast
