name=Ледяной Пик
stars=18 36 72
coins=380
width=10
height=10
tiles=
1 2 2 2 4 0 0 0 0 0
0 0 0 2 0 4 0 0 4 0
4 0 4 2 2 2 2 2 2 0
0 0 0 0 0 0 0 0 2 0
0 4 2 2 2 2 2 2 2 0
0 0 2 0 0 0 0 0 0 0
0 0 2 2 2 4 0 0 4 0
4 0 0 0 2 0 0 0 2 0
0 0 0 0 2 2 2 2 2 0
0 0 4 0 0 0 0 0 0 3
enemies=basic fast strong
