name=Лесной Тупик
stars=12 24 48
coins=320
width=10
height=10
tiles=
1 2 2 2 4 0 0 0 0 0
0 0 0 2 0 0 4 0 0 0
4 2 2 2 2 2 2 2 4 0
0 2 0 0 0 0 0 2 0 0
0 2 2 2 4 0 0 2 2 3
0 4 0 2 0 0 4 0 0 0
0 0 0 2 2 2 2 2 4 0
4 0 0 0 0 0 0 2 0 0
0 2 2 2 2 2 2 2 0 0
0 2 4 0 0 0 0 0 0 0
enemies=basic fast strong
