width=12
height=8
money=280
name=Блуждение
tiles=
4 4 0 0 0 0 0 0 0 0 2 1
4 0 0 0 2 2 2 2 0 0 2 0
0 0 0 4 2 4 4 2 2 2 2 0
0 0 0 4 2 4 0 0 0 0 0 0
0 0 0 0 2 2 2 2 4 0 0 0
2 2 2 0 0 0 0 2 4 0 0 0
2 0 2 4 4 4 0 2 0 0 4 0
3 0 2 2 2 2 2 2 0 0 0 0
waves=
basic:12
fast:6
strong:4
basic:15
fast:5
strong:4
basic:15
fast:5
