name=Дымный Карьер
stars=20 45 90
coins=450
width=14
height=9
tiles=
0 0 0 0 0 0 0 0 4 0 0 0 0 0
1 2 2 2 4 0 0 0 2 0 0 0 0 0
0 0 0 2 0 0 0 4 2 4 0 0 0 0
4 2 2 2 2 2 2 2 2 2 2 2 4 0
0 2 0 0 0 4 0 0 0 0 0 2 0 0
0 2 4 0 0 0 0 0 0 4 0 2 0 0
0 2 2 2 2 2 2 2 2 2 2 2 2 3
0 4 0 0 0 4 0 0 0 4 0 0 0 0
0 0 0 0 0 0 0 0 0 0 0 0 0 0
enemies=basic fast strong
