name=Железная Крепость
stars=40 80 160
coins=700
width=16
height=16
tiles=
0 0 0 0 0 0 0 4 0 0 0 0 0 0 0 0
0 1 2 2 2 2 2 2 2 2 2 2 2 2 3 0
0 2 0 0 0 0 0 0 0 0 0 0 0 0 2 0
0 2 0 4 2 2 2 2 2 2 2 2 4 0 2 0
0 2 0 2 2 0 0 0 0 0 0 2 2 0 2 0
0 2 0 2 0 0 0 4 0 0 0 0 2 0 2 0
0 2 0 2 0 4 2 2 2 2 4 0 2 0 2 0
0 2 0 2 0 2 2 4 4 2 2 0 2 0 2 0
0 2 0 2 0 2 4 0 0 4 2 0 2 0 2 0
0 2 0 2 0 2 2 2 2 2 2 0 2 0 2 0
0 2 0 2 0 4 0 0 0 0 4 0 2 0 2 0
0 2 0 2 2 0 0 0 0 0 0 2 2 0 2 0
0 2 0 4 2 2 2 2 2 2 2 2 4 0 2 0
0 2 0 0 0 0 0 0 0 0 0 0 0 0 2 0
0 2 2 2 2 2 2 2 2 2 2 2 2 2 2 0
0 0 0 0 0 0 0 4 0 0 0 0 0 0 0 0
enemies=basic fast strong
