width=12
height=8
money=280
name=Лабиринт
tiles=
0 0 0 0 0 0 0 0 0 0 0 0
0 1 2 2 2 2 4 0 0 0 0 0
0 4 4 2 2 4 2 2 2 2 2 3
0 0 0 4 2 4 2 4 4 4 2 0
0 4 4 2 2 4 4 4 4 4 2 0
0 4 2 2 2 2 2 2 2 4 2 0
0 4 4 4 4 4 2 2 2 2 2 0
0 0 0 0 0 0 0 0 0 0 0 0
waves=
basic:12
fast:6
strong:4
