name=Громкая Кузня
stars=15 30 60
coins=450
width=12
height=10
tiles=
0 0 0 0 0 0 0 0 0 0 0 0
0 1 2 2 2 2 2 2 2 2 4 0
0 0 0 0 0 0 0 0 0 2 0 0
0 4 2 2 2 2 2 2 2 2 0 0
0 0 2 0 0 0 0 0 0 0 0 0
0 0 2 2 2 4 2 2 2 2 4 0
0 0 0 0 2 0 2 0 0 2 0 0
0 4 2 2 2 0 2 2 2 2 0 0
0 0 2 0 0 0 0 0 0 0 0 0
0 0 2 2 2 2 2 2 2 2 2 3
enemies=basic fast strong
