name=Туманный Остров
stars=25 50 100
coins=350
width=11
height=11
tiles=
0 0 0 0 1 0 0 0 0 0 0
0 0 0 0 2 0 0 0 0 0 0
0 0 4 0 2 0 4 0 0 0 0
0 0 2 2 2 2 2 0 0 0 0
0 4 2 0 0 0 2 0 4 0 0
0 2 2 0 4 0 2 2 2 0 0
0 2 0 0 2 0 0 0 2 0 0
0 2 2 2 2 2 2 2 2 0 0
0 0 0 0 4 0 0 0 4 0 0
0 0 0 0 2 2 2 2 2 0 0
0 0 0 0 0 0 0 0 3 0 0
enemies=basic fast strong
