name=Тихая Гавань
stars=8 20 40
coins=220
width=12
height=6
tiles=
0 0 0 0 0 4 0 0 0 0 0 0
1 2 2 2 4 2 2 2 4 0 0 0
0 0 0 2 2 2 0 2 4 0 4 0
0 4 0 0 4 0 0 2 2 2 2 3
0 2 2 2 2 2 2 2 4 0 0 0
0 0 0 4 0 0 0 0 0 0 0 0
enemies=basic
